R   3000 3000
NO textures/colorstone.xpm
SO textures/greystone.xpm
WE textures/purplestone.xpm
EA textures/wood.xpm
S  textures/barrel.xpm
F 117,91,41
C 50,157,168

1111111111111111111111111
1000000000110000000000001
1011000001110000002000001
1001000000000000000000001
1111111110110000011100001
100000000011000001110111111111111
11110111111111011100000010001
11110111111111011101010010001
11000000110101011100000010N01
10002000000000001100000010001
10000000000000001101010010001
1100000111010101111101101000111
11110111 1110101 101111010001
11111111 1111111 1111111111111